9 9 9 9 9 9 9 9 9 9 9 9 9 9 9 9 9 9 9 9
9 1 5 5 5 5 2 1 5 5 5 5 2 1 5 5 5 5 2 9
9 7 0 0 0 0 8 7 0 0 0 0 8 7 0 0 0 0 8 9
9 7 0 0 0 0 8 7 0 0 0 0 8 7 0 0 0 0 8 9
9 7 0 0 0 0 8 7 0 0 0 0 8 7 0 0 0 0 8 9
9 3 6 6 6 6 4 3 6 6 6 6 4 3 6 6 6 6 4 9
9 1 5 5 5 5 2 1 5 5 5 5 2 1 5 5 5 5 2 9
9 7 0 0 0 0 8 7 0 0 0 0 8 7 0 0 0 0 8 9
9 7 0 0 0 0 8 7 0 0 0 0 8 7 0 0 0 0 8 9
9 7 0 0 0 0 8 7 0 0 0 0 8 7 0 0 0 0 8 9
9 3 6 6 6 6 4 3 6 6 6 6 4 3 6 6 6 6 4 9
9 1 5 5 5 5 2 1 5 5 5 5 2 1 5 5 5 5 2 9
9 7 0 0 0 0 8 7 0 0 0 0 8 7 0 0 0 0 8 9
9 7 0 0 0 0 8 7 0 0 0 0 8 7 0 0 0 0 8 9
9 7 0 0 0 0 8 7 0 0 0 0 8 7 0 0 0 0 8 9
9 3 6 6 6 6 4 3 6 6 6 6 4 3 6 6 6 6 4 9