1 5 5 5 5 5 5 5 5 5 5 5 5 5 5 5 5 5 5 2
7 0 0 0 0 0 0 0 0 0 0 0 0 0 0 0 0 0 0 8
7 0 11 12 12 12 12 12 12 12 13 13 13 13 13 13 13 11 0 8
7 0 11 13 13 13 13 13 13 11 11 12 12 12 12 12 12 11 0 8
7 0 11 10 11 12 12 12 12 12 13 13 13 13 13 11 10 11 0 8
7 0 11 10 11 13 13 13 13 11 11 12 12 12 12 11 10 11 0 8
7 0 11 10 11 10 11 12 0 0 0 0 13 11 10 11 10 11 0 8
7 0 11 10 11 10 11 10 0 0 0 0 10 11 10 11 10 11 0 8
7 0 11 10 11 10 11 10 0 0 0 0 10 11 10 11 10 11 0 8
7 0 11 10 11 10 11 10 0 0 0 0 10 11 10 11 10 11 0 8
7 0 11 10 11 10 12 10 0 0 0 0 10 13 10 11 10 11 0 8
7 0 11 10 13 13 13 13 13 10 10 12 12 12 12 12 10 11 0 8
7 0 11 10 12 12 12 12 12 12 13 13 13 13 13 13 10 11 0 8
7 0 13 13 13 13 13 13 13 10 10 12 12 12 12 12 12 12 0 8
7 0 0 0 0 0 0 0 0 0 0 0 0 0 0 0 0 0 0 8
3 6 6 6 6 6 6 6 6 6 6 6 6 6 6 6 6 6 6 4

