1 5 5 5 5 5 5 5 5 5 5 5 5 5 5 5 5 5 5 2
7 0 0 0 0 0 0 0 0 0 0 0 0 0 0 0 0 0 0 8
7 0 13 11 11 10 12 10 12 10 12 12 12 12 10 13 11 10 0 8
7 0 13 9 9 10 13 13 13 11 11 12 9 9 10 10 11 10 0 8
7 0 13 9 13 13 13 13 11 11 13 11 10 9 9 10 13 10 0 8
7 0 10 9 12 10 11 12 12 11 11 13 11 10 10 11 10 13 0 8
7 0 12 10 13 11 11 13 9 9 9 9 11 13 9 9 12 12 0 8
7 0 12 10 10 12 11 13 9 9 9 9 12 13 9 11 11 13 0 8
7 0 12 10 11 12 12 13 9 9 9 9 13 13 9 11 10 13 0 8
7 0 12 10 11 13 13 11 9 9 9 9 13 11 9 9 13 13 0 8
7 0 13 10 9 10 10 11 13 13 13 11 10 13 10 10 12 12 0 8
7 0 11 9 9 10 10 13 10 13 13 13 10 11 13 10 10 11 0 8
7 0 11 9 9 11 10 12 12 9 12 13 11 9 9 12 11 12 0 8
7 0 12 10 10 13 13 13 13 10 10 10 11 10 13 10 13 13 0 8
7 0 0 0 0 0 0 0 0 0 0 0 0 0 0 0 0 0 0 8
3 6 6 6 6 6 6 6 6 6 6 6 6 6 6 6 6 6 6 4